%%%%%
% . %
%   %
%   %
%   %
% . %
% P %
%%%%%
