%%%%%%%%%%%
% ....... %
% %%%%%%. %
% ....... %
% .%%%%%% %
% ....... %
% %%%%%%. %
% ....... %
% P       %
%%%%%%%%%%%
