%%%%%
%...%
%   %
%   %
%P  %
%%%%%
