%%%%%
% ..%
% . %
% P %
%   %
% . %
%%%%%
