%%%%%
% ..%
% . %
% P %
% . %
%%%%%
